2222222222222222222222222222222222222222222222222222222222222222
2222222222222222222222222222222222222222222222222222222222222222
2222000100000000000000000000000000000000000000000000000000022222
2222000100000010000000000000000000000000000100000000000000022222
2222000100000000000000000000000000000001000000000000000000022222
2222000100000000000000000000000000000000000000000000000000022222
2222000111110000000000000000000000000000000000000000000000022222
2222000000030000000000000000000000000000000000000000000000022222
2222000000000000000000000000000000000000000000000000000000022222
2222000000000000000000000000000000000000000000000000000000022222
2222000000000000000000000000000000000000000000000000000000022222
2222000000000000000000000000000100000000000000000000000000022222
2222000000000000000000000000000000000000000000000000000000022222
2222000000000000000000000000000000000000000000000000000000022222
2222000000000000000000000000000000000000000000000000000000022222
2222000001000000000000000000000000000000000000000000000000022222
2222000000000000000000000000000000000000000003000000000000022222
2222000000000000000000000000000000000000000000000000000000022222
2222000000000000000000000000000000000000000000000000000000022222
2222000000000000000000000000000000000000000000000000000000022222
2222000000000000000000000000000000000000000001000000000000022222
2222000000000000000000000000000000000000000000000000000000022222
2222000000000000100000000000000000000000000000000000000000022222
2222000000003000000000000000000000000000000000000000000000022222
2222000000000000000000011111000010000000000000000000000000022222
2222000000000000000000011111000000000000000000000000000000022222
2222000000000000000000011110000000000000000000000000000000022222
2222000000000000000000001000000000000000000000000000000000022222
2222000000000000000000000000000000000000000030000000000000022222
2222000001000000000000000000000000000000000000000000000000022222
2222000000000000000000000100000000000000000001000000000000022222
2222000000000000000000000000000000000000000000000000000000022222
2222000000000000000000000000000000000000000000000000000000022222
2222000000000000000000000000000000000000000000000000000000022222
2222000000000000000000000000000000000000000000000000000000022222
2222000000000000000000000000000000000000000000000000000000022222
2222000000001000000001000000000000000000000000000000000000022222
2222000000000030000000000000000000100000000010000000000000022222
2222000000100000000000000000000000110000000000000000000000022222
2222000000000000000000000000000000100000000000000000000000022222
2222000000000000000000000000000000000000000000000000000000022222
2222000000000000000000000000000000000000000000000000000000022222
2222000000000000000000000000000000001100000000003000000000022222
2222000000000000000000000000000000000000000000000000000000022222
2222000001000000000000000000000000000000000000000000000000022222
2222000000000000000000000001000000000000000000000000000000022222
2222000000000300000000000000000000000000000000000000000000022222
2222000000000011000000000000000000000000010000000000000000022222
2222000000000000000000000000000000000000000000000000000000022222
2222000000000000000000011000000000000000000000000000000000022222
2222000000000000000000000000000000000000000000000000000000022222
2222000000000000000000000000000000000000000000000000000000022222
2222000000000000000000000000000000000000000000000000000000022222
2222000000000000000000000000000000000000000000000000000000022222
2222000000000100000000000000000011000000000000000000000000022222
2222000000000000000000000300000000000000000000000000000000022222
2222000000000001000000000000000000000000000000000000000000022222
2222000000000000000000000000000000000000000000000000000000022222
2222000000000000000000000000000000000000000000000000000000022222
2222000000000000000000000000000000000001000000000000000000022222
2222000000000000000000000000000000000000000000000000000000022222
2222000000000000000000000000000000000000000000000000000000022222
2222222222222222222222222222222222222222222222222222222222222222
2222222222222222222222222222222222222222222222222222222222222222