2222222222222222222222222222222222222222222222222222222222222222
2222222222222222222222222222222222222222222222222222222222222222
2222220010022222222022222222222022200222222222222220000022222222
2222222000000002222222222201101002000022222222220000000002222222
2222200000000100222222222000000000220122222222000000000000022222
2222200013000110002222220000000000020002222222200001111000002222
2222200001000100002222220000000000120000222222200011110000002222
2222010000000000000222222000000002220000022220000000103002000022
2222000000000000002222220000100031200000222200000000100002000022
2220000000002222002222000000000000000100002220000011100012000022
2200000001002112222222200000100011000000222222000000000022000022
2220000000002222002220000000000022000000000220000000000220000022
2222000010110000000200200000000020000100020000000010002220000022
2220010000000000000002200010002210000000222000000110022200000022
2220000000000000000002222000022000000000222000000000002220000022
2200000001000100000222222200221000001022222220000000002222222222
2202000000000000022222222212000000000222222222000000000022222222
2002100000000000222222222222000000100222222222220000000002222222
2002200000010022222222222222001000002222222222222000000222222222
2222000000022222222222222222200022222222222222222200222222222222
2222200022222222222222222222222222222222222222222222222000222222
2222222222222222222222222222222222222222222222222222222222222222
2222222222222222222222222220000000000222222222222222000222222222
2222222200002222222222222000000000000010222222222000000002222022
2222222000000000022222200011110100000011222222200000000002200022
2222220001010000002222200000110000000011112222220001002222000222
2222222000000000002222000000000000000000022222000000022220002222
2222222001000000002222222200011100000000000022220000322200000222
2222222220000100000222220000001100000000000220000010022220000000
2222222200000000002222200000000011110000000222200010002222000002
2222222101131000022222220000000100000000102222000100000002201002
2222222000100000222222111000001110000000122200001000001000000022
2220222211100000012222220011110010000011112220000110000000002222
2222222220000000000222200222111000000011122200001000010002222222
2222222000010000002222000220001111000000012220000000110000022222
2222220000000100022222022200000000000000222200000000000010222222
2222220000010000022222222220000000000000022000000201000000022222
2222222100000000022222222200000000000000222220002220000002222222
2222220000000000222222222200010000010002222222000220000222222222
2222200000000102222222220000011100000022222222002200002222222222
2222000001000022222222222000111100000000022222222222222222222222
2222220002222222222222222222000111000000002222222222222200022222
2222222200222222222222222222222222222220002222222222222002222222
2222222220002222222222222222222222222222222222222222210222222222
2222220000100000222222222200222222222021222222222000001000022222
2222220000000000002222222000002222220000222220010100100101000222
2222200010002100002222200010022222220100022220000010000000000022
2222200010222000000222222000022222222200222222100001011010002222
2222000002222200100222200010222222222200222222201013001100002222
2222000000222220002222222000002222200000222200010001110001002222
2220000000001122202222222000000222000000222200011000000011002222
2220000001002222000222222100000002200000222200011001110000022222
2222000311122222222222220000011022200000022222000000001010002222
2222000000011222222222220000000030000000002222220011011000000222
2220000001000000000222200010001000000002222222220001100010022222
2200000011000000000222222200000000000000222220000100000000022222
2222000010000000022222220100000000000002222222200010011000002222
2222200110000000002222222220000000100002022222200111000101000022
2222220000000000002222222222200000000002222222222010001010100000
0222222000000000002222222222200010000002222222222222000010100000
0002220000000000222222222220100000000002222222222222200000011000
0022222222000022222222222222200000002222222222222222222222000022
2000222222222222222222222222222222222222222222222222222222222222
2200022222222222222222222222222222222222222222222222222222222222